XXXXXXXXXXXXXXXXXXXXXXXXXXXXXXXXXXXXXXXXXXXXXXXXXXX
P   X           X       X       X         X       X
X X X XXXXX XXX X XXX XXX X XXX X XXXXXXX X XXXXX X
X X X X   X X   X   X     X X X   X         X     X
XXX X X X X XXXXXXX XXXXXXX X X XXXXXXX XXXXX X X X
X   X   X X         X     X X   X     X X     X X X
X XXXXXXX XXXXXXXXXXX X X X XXX X XXX XXX XXXXX XXX
X X     X         X   X X X   X X   X     X   X   X
X X X XXXXXXXXXXX X XXX XXXXX X XXX XXXXXXX XXXXX X
X X X X     X   X X   X X     X X           X     X
X X X X XXX X X X XXX X X XXXXXXX XXXXXXX XXX XXX X
X   X X X   X X X X   X X   X   X X   X   X   X   X
X XXX X X XXX X X XXXXX XXX X X X X X XXXXX XXXXX X
X X   X X     X   X   X   X   X   X X     X X   X X
X X XXX XXXXXXXXXXX X XXX XXXXXXXXX XXXXX X X X XXX
X X     X       X   X   X   X     X X     X   X   X
X XXXXXXX XXXXX X XXXXX X XXX XXX X X XXXXX XXXXX X
X X   X       X X     X   X   X X X X   X   X   X X
X X X XXXXXXX X XXXXX X XXX XXX X X XXX XXXXX X X X
X   X         X       X X   X       X         X   K
XXXXXXXXXXXXXXXXXXXXXXXXXXXXXXXXXXXXXXXXXXXXXXXXXXX
